1111111111111
1111111111111
1001000C000C1
10000111110C1
111P11EC00001
1111111111111